[info]
fondo:fondo.jpg
mapa: 000000000000000000000000000000000000000000000000000000000000000000000000000000000000000000000000000
      000000000000000000000000000000000000000000000000000000000000000000000000000000000000000000000000000
      000000000000000000000000000000000000000000000000000000000000000000000000000000000000000000000000000
      000000000000000000000000000000000000000000000000000000000000000000000000000000000000000000000000000
      000000000000000000000000eddf00000000000000000000000edddgi000000000000000000000000000000000000000000
      000000000000000000000000kjjl00000000000000000000000kjjl000000000hgi00000000000000000000000000000000
      000000000000000000000000kjjl00000000000000000000000kjjl00000000000000000000000000000000000000000000
      113000000000000000000000kjjl00000000000000000000000kjjl0000hgi0000000000000000000000000000000000000
      777300000000000000000000kjjl00000000000000000000000kjjl00000000000000000000000000000000000000000000
      777730000000000000000000kjjl00000000000000000000000kjjl000000000000hgi000000000000hgi00000000000000
      777773000000000000000000kjjl00000000000000000000000kjjl00000000000000000000000000000000000000000000
      777777300000000000000000kjjjdddddddddddddddddddddddjjjl000000000000000000hgi000000000000hgi00000000
      777777730000000000000000kjjjjjjjjjjjjjjjjjjjjjjjjjjjjjl00000000000000000000000000000000000000000211
      777777773000000000000000hoooooooooooooooooooooooooooooi00000000000000000000000000000000000000002777
      777777777300000000000000000000000000000000000000000000000000000000000000000000000000000000000027777
      777777777730000000000000000000000000000000000000000000000000000000000000000000000000000000000277777
      777777777773000000000000000000000000000000000000000000000000000000000000000000000000000000002777777
      777777777777300000000000000000000000000000000000000000000000000000000000000000000000000000027777777
      777777777777730000000000000000000000000000000000000000000000000000000000000000000000000000277777777
      777777777777773000000000000000000000000000000000000000000000000000000000000000000000000002777777777
      777777777777777300000000000000000000000000000000000000000000000000000000000000000000000027777777777
      777777777777777730000000000000000000000000000000000000000000000000000000000000000000000277777777777
      777777777777777773000000000000000000000000000000000000000000000000000000000000000000002777777777777
      777777777777777777300000000000000000000000000000000000000000000000000000000000000000027777777777777
      777777777777777777730000000000000000000000000000000000000000000000000000000000000000277777777777777
      777777777777777777773000000000000000000000000000000000000000000000000000000000000002777777777777777
      777777777777777777777300000000000000000000000000000000000000000000000000000000000027777777777777777
      777777777777777777777730000000000000000000000000000000000000000000000000000000000277777777777777777
      777777777777777777777773000000000000000000000000000000000000000000000000000000021777777777777777777
      777777777777777777777777300000000000000000000000000000000000000000000000000002177777777777777777777
      777777777777777777777777730000000000000000000000000000000000000000000000000217777777777777777777777
      777777777777777777777777773000000000000000000000000000000000000000000000021777777777777777777777777
      777777777777777777777777777300000000000000000000000000000000000000000021177777777777777777777777777
      777777777777777777777777777730000000000000000000000000000000000000021177777777777777777777777777777
      777777777777777777777777777773000000000000000000000000000000000021177777777777777777777777777777777
      777777777777777777777777777777300000000000000000000000000000021177777777777777777777777777777777777
      777777777777777777777777777777730000000000000000000000000021177777777777777777777777777777777777777
      777777777777777777777777777777773000000000000000000000021177777777777777777777777777777777777777777
      777777777777777777777777777777777300000000000000000021177777777777777777777777777777777777777777777
      777777777777777777777777777777777730000000000000021177777777777777777777777777777777777777777777777
      7777777777777777777777777777777777730uttttttttv0277777777777777777777777777777777777777777777777777
      777777777777777777777777777777777777300000000002777777777777777777777777777777777777777777777777777
      777777777777777777777777777777777777900000000008777777777777777777777777777777777777777777777777777
      777777777777777777777777777777777777900000000008777777777777777777777777777777777777777777777777777
      777777777777777777777777777777777777900000000008777777777777777777777777777777777777777777777777777
      777777777777777777777777777777777777900000000008777777777777777777777777777777777777777777777777777
      777777777777777777777777777777777777900000000008777777777777777777777777777777777777777777777777777
      777777777777777777777777777777777777900000000008777777777777777777777777777777777777777777777777777
      777777777777777777777777777777777777900000000008777777777777777777777777777777777777777777777777777
      777777777777777777777777777777777777900000000008777777777777777777777777777777777777777777777777777
[0]
tipo: vacio
spr:0

[1]
tipo: suelo
spr:1

[2]
tipo: suelo
spr:2

[3]
tipo: suelo
spr:3

[7]
tipo: muro
spr:7

[8]
tipo: muro
spr:8

[9]
tipo: muro
spr:9

[d]
tipo: suelo
spr:13

[e]
tipo: suelo
spr:14

[f]
tipo: suelo
spr:15

[g]
tipo: plataforma
spr:16

[h]
tipo: plataforma
spr:17

[i]
tipo: plataforma
spr:18

[j]
tipo: muro
spr:19

[k]
tipo: muro
spr:20

[l]
tipo: muro
spr:21

[o]
tipo: muro
spr:24

[t]
tipo: puente
spr:29

[u]
tipo: puente
spr:30

[v]
tipo: puente
spr:31
