[info]
fondo:fondo.jpg
mapa: 000000000000000000000000000000000kjjl00000000000000000000000000000000000000000000000000000000000000000000000
      000000000000000000000000000000000kjjl00000000000000000000000000000000000000000000000000000000000000000000000
      000000000000000000000000000000000kjjl00000000000000000000000000000000000000000000000000000000000000000000000
      000000000000000000000000000000000kjjl00000000000000000000000000000000000000000000000000000000000000000000000
      000000000000000000000000000000000kjjl00000000000000000000000000000000000000000000000000000000000000000000000
      000000000000000000000000000000000kjjl00000000000000000000000000000000000000000000000000000000000000000000000
      000000000000000000000000000000000kjjl00000000000000000000000000000000000000000000000000000000000000000000000
      000000000000000000000000000000000kjjl00000000000000000000000000000000000000000000000000000000000000000000000
      000000000000000000000000000000000kjjl00000000000000000000000000000000000000000000000000000000000000000000000
      000000000000000000000000000000000kjjjdddddddddddddddddddddddddddddddddddddddd1111111111300000005460000000000
      000011300000000000000000000000000kjjlooooooooooooooooooooooooooooooooooooooooccccccccccb00000000000000000000
      000077900000000000000000000000000kjjl00000000000000000000000000000000000000000000000000000000000000000000000
      000077900000000000000000000000000kjjl00000000000000000000000000000000000000000000000000054600000000000000000
      000077713000000000000000000000000kjjl00000000000000000000000000000000000000000000000000000000000000000000000
      000077779000000000000000000000000kjjl00000000000000000000000000000000000000000000000000000000000000000000000
      000077779000000000000000000000000kjjl00000000000000000000000000000000000000000000000000000000000054600000000
      000077779000000000000000000000000rrrr00000000000000000000000000000000000000000000000000000000000000000000000
      000077779000000000000000000000000000000000000000000000000000000000000000000000000000000000000000000000000000
      000077779000000000000000000000000000000000000000000000000000000000000000000000000000000546000000000000000000
      000077777113000000000000000000000000000000000000000000000000000000000000000000000000000000000000000000000000
      000077777779000000000000000000000000000000000000000000000000000000000000000000000000000000000000000000000000
      000077777777113000000000000000000000000000000000000000000000000000000000000000000000000000000000054600000000
      000077777777779000000000000000000002130000000000000000000000000000000000000000000000000000000000000000000000
      000077777777777113q00000000000000007790000000000000000000000000000000000000000000000000000000000000000000000
      000077777777777779q00000000000002117790000000000000000000000000000000000000000000000000546000000000000000000
      000077777777777779q00000000000007777790000000000000000000000000000000000000000000000000000000000000000000000
      000077777777777779q00000000002117777771111130000000000000000000000000000000000000000000000000000000000000000
      000077777777777779000000000007777777777777790000000000000000000000000000000000000000000000000000054600000000
      000077777777777779000000002117777777777777790000000000000000000000000000000000000000000000000000000000000000
      000077777777777779000000008777777777777777790000000000000000000000000000000000000000000000000000000000000000
      000077777777777779460002117777777777777777771111111111130005460000000000000546000000000546000000000000000000
      000077777777777779000008777777777777777777777777777777790000000000000000000000000000000000000000000000000000
      000077777777777779000008777777777777777777777777777777790000000000000000000000000000000000000000000000000000
      000077777777777779000548777777777777777777777777777777790000000005460000000000000000000005460000546000000000
      000077777777777779000008777777777777777777777777777777790000000000000000000000000000000000000000000000000000
      000077777777777779000008777777777777777777777777777777790000000000000000000000000000000000000000000000000000
      000077777777777779460008777777777777777777777777777777790000000000000000000000005460000000000000000000000000
      000077777777777779000008777777777777777777777777777777790000000000000000000000000000000000000000000000000000
      000077777777777779000008777777777777777777777777777777790000000000000000000000000000000000546000000000000000
      000077777777777779000548777777777777777777777777777777790000000000000000546000000000000000000000000000000000
      000077777777777779000008777777777777777777777777777777790000000000000000000000000000000000000000054600000000
      000077777777777779000008777777777777777777777777777777790000000000000000000000000000000000000000000000000000
      000077777777777779460008777777777777777777777777777777790000000000000000000000000000000000000000000000000000
      000077777777777779000008777777777777777777777777777777790000000000000000000000000000000000000000000000000000
      000077777777777779000008777777777777777777777777777777790000000000000000000000000000000000000000000000000000
      000077777777777777111117777777777777777777777777777777790000000000000000000000000000000000000000000000000000
      000077777777777777777777777777777777777777777777777777790000000000000000000000000000000000000000000000000000
      000077777777777777777777777777777777777777777777777777790000000000000000000000000000000000000000000000000000
      000077777777777777777777777777777777777777777777777777790000000000000000000000000000000000000000000000000000
      000077777777777777777777777777777777777777777777777777790000000000000000000000000000000000000000000000000000
      000077777777777777777777777777777777777777777777777777790000000000000000000000000000000000000000000000000000

[0]
tipo: vacio
spr:0

[1]
tipo: suelo
spr:1

[2]
tipo: suelo
spr:2

[3]
tipo: suelo
spr:3

[4]
tipo: plataforma
spr:4

[5]
tipo: plataforma
spr:5

[6]
tipo: plataforma
spr:6

[7]
tipo: muro
spr:7

[8]
tipo: muro
spr:8

[9]
tipo: muro
spr:9

[b]
tipo: muro
spr:11

[c]
tipo: muro
spr:12

[d]
tipo: suelo
spr:13

[j]
tipo: muro
spr:19

[k]
tipo: muro
spr:20

[l]
tipo: muro
spr:21

[o]
tipo: muro
spr:24

[q]
tipo:pincho
spr:26

[r]
tipo: pincho
spr:27
