[info]
fondo:fondo.jpg
mapa: 00000000000000000000000000000kjjl000000000000000000000000000000000000000000000000000000000000000000
      00000000000000000000000000000kjjl000000000000000000000000000000000000000000000000000000000000000000
      00000000000000000000000000000kjjl000000000000000000000000000000000000000000000000000000000000000000
      00000000000000000000000000000kjjl000000000000000000000000000000000000000000000000000000000000000000
      00000000000000000000000000000kjjl000000000000000000000000000000000000000000000000000000000000000000
      00000000000000000000000000000kjjl000000000000000000000000000000000000000000000000000000000000000000
      00000000000000000000000000000kjjl000000000000000000000000000000000000000000000000000000000000000000
      00000000000000000000000000000kjjl000000000000000000000000000000000000000000000000000000000000000000
      00000000000000000000000000000kjjjdddddddddddddddddddddddddddddddddddddddd11111111113000000054600000
      11300000000000000000000000000kjjlooooooooooooooooooooooooooooooooooooooooccccccccccb000000000000000
      77900000000000000000000000000kjjl000000000000000000000000000000000000000000000000000000000000000000
      77900000000000000000000000000kjjl000000000000000000000000000000000000000000000000000546000000000000
      77713000000000000000000000000kjjl000000000000000000000000000000000000000000000000000000000000000000
      77779000000000000000000000000kjjl000000000000000000000000000000000000000000000000000000000000000000
      77779000000000000000000000000kjjl000000000000000000000000000000000000000000000000000000000000546000
      77779000000000000000000000000kjjl000000000000000000000000000000000000000000000000000000000000000000
      77779000000000000000000000000kjjl000000000000000000000000000000000000000000000000000000000000000000
      77779000000000000000000000000rrrr000000000000000000000000000000000000000000000000005460000000000000
      777771130000000000000000000000000000000000000000000000000000000000000000000000000000000000000000000
      777777790000000000000000000000000000000000000000000000000000000000000000000000000000000000000000000
      777777771130000000000000000000000000000000000000000000000000000000000000000000000000000000000546000
      777777777790000000000000000000021300000000000000000000000000000000000000000000000000000000000000000
      77777777777113q000000000000000077900000000000000000000000000000000000000000000000000000000000000000
      77777777777779q000000000000021177900000000000000000000000000000000000000000000000005460000000000000
      77777777777779q000000000000077777900000000000000000000000000000000000000000000000000000000000000000
      77777777777779q000000000021177777711111300000000000000000000000000000000000000000000000000000000000
      777777777777790000000000077777777777777900000000000000000000000000000000000000000000000000000546000
      777777777777790000000021177777777777777900000000000000000000000000000000000000000000000000000000000
      777777777777790000000087777777777777777900000000000000000000000000000000000000000000000000000000000
      777777777777790000021177777777777777777711111111111300054600000000000000000000000005460000000000000
      777777777777794600087777777777777777777777777777777900000000000000000000000000000000000000000000000
      777777777777790000087777777777777777777777777777777900000000000000000000000000000000000000000000000
      777777777777790005487777777777777777777777777777777900000000054600000000000000000000054600005460000
      777777777777790000087777777777777777777777777777777900000000000000000000000000000000000000000000000
      777777777777790000087777777777777777777777777777777900000000000000000000000000000000000000000000000
      777777777777794600087777777777777777777777777777777900000000000000000000000054600000000000000000000
      777777777777790000087777777777777777777777777777777900000000000000000000000000000000000000000000000
      777777777777790000087777777777777777777777777777777900000000000000000000000000000000005460000000000
      777777777777790005487777777777777777777777777777777900000000000000005460000000000000000000000000000
      777777777777790000087777777777777777777777777777777900000000000000000000000000000000000000000546000
      777777777777790000087777777777777777777777777777777900000000000000000000000000000000000000000000000
      777777777777794600087777777777777777777777777777777900000000000000000000000000000000000000000000000
      777777777777790000087777777777777777777777777777777900000000000000000000000000000000000000000000000
      777777777777790000087777777777777777777777777777777900000000000000000000000000000000000000000000000
      777777777777771111177777777777777777777777777777777900000000000000000000000000000000000000000000000
      777777777777777777777777777777777777777777777777777900000000000000000000000000000000000000000000000
      777777777777777777777777777777777777777777777777777900000000000000000000000000000000000000000000000
      777777777777777777777777777777777777777777777777777900000000000000000000000000000000000000000000000
      777777777777777777777777777777777777777777777777777900000000000000000000000000000000000000000000000
      777777777777777777777777777777777777777777777777777900000000000000000000000000000000000000000000000
[0]
tipo: vacio

[1]
tipo: suelo

[2]
tipo: suelo

[3]
tipo: suelo

[4]
tipo: plataforma

[5]
tipo: plataforma

[6]
tipo: plataforma
