[info]
fondo:fondo.jpg
mapa: 000000000000000000000000000000000kjjl0000000000000000000000000000000000000000000000000000000000000000000
      000000000000000000000000000000000kjjl0000000000000000000000000000000000000000000000000000000000000000000
      000000000000000000000000000000000kjjl0000000000000000000000000000000000000000000000000000000000000000000
      000000000000000000000000000000000kjjl0000000000000000000000000000000000000000000000000000000000000000000
      000000000000000000000000000000000kjjl0000000000000000000000000000000000000000000000000000000000000000000
      000000000000000000000000000000000kjjl0000000000000000000000000000000000000000000000000000000000000000000
      000000000000000000000000000000000kjjl0000000000000000000000000000000000000000000000000000000000000000000
      000000000000000000000000000000000kjjl0000000000000000000000000000000000000000000000000000000000000000000
      000000000000000000000000000000000kjjl0000000000000000000000000000000000000000000000000000000000000000000
      000000000000000000000000000000000kjjjdddddddddddddddddddddddddddddddddddddddd111111111130000000546000000
      000011300000000000000000000000000kjjlooooooooooooooooooooooooooooooooooooooooccccccccccb0000000000000000
      000077900000000000000000000000000kjjl0000000000000000000000000000000000000000000000000000000000000000000
      000077900000000000000000000000000kjjl0000000000000000000000000000000000000000000000000005460000000000000
      000077713000000000000000000000000kjjl0000000000000000000000000000000000000000000000000000000000000000000
      000077779000000000000000000000000kjjl0000000000000000000000000000000000000000000000000000000000000000000
      000077779000000000000000000000000kjjl0000000000000000000000000000000000000000000000000000000000005460000
      000077779000000000000000000000000rrrr0000000000000000000000000000000000000000000000000000000000000000000
      00007777900000000000000000000000000000000000000000000000000000000000000000000000000000000000000000000000
      00007777900000000000000000000000000000000000000000000000000000000000000000000000000000054600000000000000
      00007777711300000000000000000000000000000000000000000000000000000000000000000000000000000000000000000000
      00007777777900000000000000000000000000000000000000000000000000000000000000000000000000000000000000000000
      00007777777711300000000000000000000000000000000000000000000000000000000000000000000000000000000005460000
      00007777777777900000000000000000000213000000000000000000000000000000000000000000000000000000000000000000
      000077777777777113q0000000000000000779000000000000000000000000000000000000000000000000000000000000000000
      000077777777777779q0000000000000211779000000000000000000000000000000000000000000000000054600000000000000
      000077777777777779q0000000000000777779000000000000000000000000000000000000000000000000000000000000000000
      000077777777777779q0000000000211777777111113000000000000000000000000000000000000000000000000000000000000
      00007777777777777900000000000777777777777779000000000000000000000000000000000000000000000000000005460000
      00007777777777777900000000211777777777777779000000000000000000000000000000000000000000000000000000000000
      00007777777777777900000000877777777777777779000000000000000000000000000000000000000000000000000000000000
      00007777777777777946000211777777777777777777111111111113000546000000000000054600000000054600000000000000
      00007777777777777900000877777777777777777777777777777779000000000000000000000000000000000000000000000000
      00007777777777777900000877777777777777777777777777777779000000000000000000000000000000000000000000000000
      00007777777777777900054877777777777777777777777777777779000000000546000000000000000000000546000054600000
      00007777777777777900000877777777777777777777777777777779000000000000000000000000000000000000000000000000
      00007777777777777900000877777777777777777777777777777779000000000000000000000000000000000000000000000000
      00007777777777777946000877777777777777777777777777777779000000000000000000000000546000000000000000000000
      00007777777777777900000877777777777777777777777777777779000000000000000000000000000000000000000000000000
      00007777777777777900000877777777777777777777777777777779000000000000000000000000000000000054600000000000
      00007777777777777900054877777777777777777777777777777779000000000000000054600000000000000000000000000000
      00007777777777777900000877777777777777777777777777777779000000000000000000000000000000000000000005460000
      00007777777777777900000877777777777777777777777777777779000000000000000000000000000000000000000000000000
      00007777777777777946000877777777777777777777777777777779000000000000000000000000000000000000000000000000
      00007777777777777900000877777777777777777777777777777779000000000000000000000000000000000000000000000000
      00007777777777777900000877777777777777777777777777777779000000000000000000000000000000000000000000000000
      00007777777777777711111777777777777777777777777777777779000000000000000000000000000000000000000000000000
      00007777777777777777777777777777777777777777777777777779000000000000000000000000000000000000000000000000
      00007777777777777777777777777777777777777777777777777779000000000000000000000000000000000000000000000000
      00007777777777777777777777777777777777777777777777777779000000000000000000000000000000000000000000000000
      00007777777777777777777777777777777777777777777777777779000000000000000000000000000000000000000000000000
      00007777777777777777777777777777777777777777777777777779000000000000000000000000000000000000000000000000

[0]
tipo: vacio
spr:0

[1]
tipo: suelo
spr:1

[2]
tipo: suelo
spr:2

[3]
tipo: suelo
spr:3

[4]
tipo: plataforma
spr:4

[5]
tipo: plataforma
spr:5

[6]
tipo: plataforma
spr:6

[7]
tipo: muro
spr:7

[8]
tipo: muro
spr:8

[9]
tipo: muro
spr:9

[b]
tipo: muro
spr:11

[c]
tipo: muro
spr:12

[d]
tipo: suelo
spr:13

[j]
tipo: muro
spr:19

[k]
tipo: muro
spr:20

[l]
tipo: muro
spr:21

[o]
tipo: muro
spr:24

[q]
tipo:pincho
spr:26

[r]
tipo: pincho
spr:27
